1111111111141111111111
1000000000000000000001
1010011111111111100101
1010011111111111100101
1010000000000000000101
1010111011331101110101
1010150012222100510101
1010111011111101110101
1500000000000000000051
1101011111001111101011
4001011111001111101004
4001000000000000001004
1101011111001111101011
1500000000000000000051
1011111011111101111101
1010000000000000000101
1010111011001101110101
1010151011001101510101
1010001011001101000101
1011111011111101111101
1000000000000000000001
1111111111111111111111
--




